w#kk# s km 
 #kk# ####y
 ##m# #h g 
 yy y #   f
 #### #####
  ms k gj  
##### #### 
s   # yy y 
 f o# ##m#m
y#### #  # 
 m  g #hh#t
