####   ####
ggg## ##ggg
 j r   r j 
####d d####
gog## ##gpg
 j ## ## j 
   ## ##   
y#y##r##y#y
 # #   # # 
w# s   s #l
