t#p# u #k#m
 #h#   #k#m
 #f#m#j#h#m
 # # # # # 
y#y#b#y#g#y
 j s       
y#y#y#y#j#y
 # # # # # 
 # #f#m#l# 
m#m#k#f#k# 
 m #k#l#k#w
