t# my #  y 
 #  #k#mm#m
 ym # #kk# 
###y#f#kk# 
k s # #### 
k  f# m    
#j### ####m
    #m#    
okh # #y###
##### # #  
w     #ky  
