w b        
  ##     ##
 ##### ####
 #kk#   #  
 #k r   r  
 ####   ###
 #  #   #  
 #  r   r  
 ####   ###
 #ll#   #  
t#l r   r  
