t mmm      
########## 
h  y #pk # 
 g # #oh # 
#y## ###y# 
k  # yfsf# 
 j # ##### 
#y##       
   ##y###y#
h k#ki # f 
h k#   #mlm
