 e #i  # q 
h k#   #k l
   #   # j 
#y###b###y#
 s y m  g  
   ########
m m        
y##y###y##y
 # f # s # 
 #m k#p h# 
t#kmk# m #w
