  gy w ym h
 k #   # m 
j####b#### 
 k #k kyy  
o f# p ##@#
######m#  j
k yjk# #c# 
j #  # ###y
y###y# #k s
 h# g#f# g 
  b  y ys h
