w yy t #k k
  ##  m# d 
y####y##l h
 #kkk  ##r#
h#####s#   
 mmm # #   
####y#f##y#
   f g s   
y#########y
m #pk#eh# g
 fbko#k yj 
