w#kk# s km 
 #kk# ####y
 ##m# #h g 
 yy y #u  f
 #### #####
  ms k gj  
##### #### 
s  q# yy y 
 f o# ##m#m
y#### #  # 
 m  g #hh#t
