ko#klk# # h
 h#lkl# yf 
s #kek# ###
y### ## # q
  f   m    
y##   # ##@
g ## ## # h
 k#   # ysk
hp#   # ###
#### ##m#  
w     # y t
