w b        
  ##     ##
 ##### ####
 #kk#   # q
 #k n   n  
 ####   ###
 @  #   # u
 #  n   n  
 ####   ###
 #ll#   #  
t#l n   n  
