w b        
  ##     ##
 ##### ####
 #kk#   # q
 #k r   r  
 ####   ###
 @  #   # u
 #  r   r  
 ####   ###
 #ll#   #  
t#l r   r  
